Version 1
Start 6 4
Tiles
0 null 0
1 forest-floor 1
2 leaves 0
3 leaves-bottom 0
4 tree-trunk 0
5 bushes 0
Pattern
1 1 1 1 1 0 0 0 0 0 0 3 2 2 2
1 1 1 1 0 0 0 0 0 0 3 2 2 2 2
1 1 1 0 0 0 0 0 0 3 2 2 2 2 2
1 1 1 4 4 4 4 4 4 3 2 2 2 2 2
1 1 1 0 0 0 0 0 0 3 2 2 2 2 2
1 1 1 5 0 0 0 0 0 0 3 2 2 2 2
1 1 1 5 0 0 0 0 0 0 3 2 2 2 2
1 1 1 5 0 0 0 0 0 0 0 3 2 2 0
1 1 1 0 0 0 0 0 0 0 0 0 0 0 0
1 0 0 0 0 0 0 0 0 0 0 0 0 0 0
1 1 1 0 0 0 0 0 0 0 3 2 2 2 0
1 1 1 5 0 0 0 0 0 3 2 2 2 2 2
1 1 1 4 4 4 4 4 4 3 2 2 2 2 2
1 1 1 5 0 0 0 0 0 3 2 2 2 2 2
1 1 1 5 0 0 0 0 0 0 3 2 2 2 2
1 1 1 5 0 0 0 0 0 0 3 2 2 2 2
1 1 1 4 4 4 4 4 4 3 2 2 2 2 2
1 1 1 5 0 0 0 0 0 0 3 2 2 2 2
1 1 1 0 0 0 0 0 0 0 0 3 2 2 2
1 1 1 1 1 1 1 0 0 0 3 2 2 2 2
End
